NO 	./images/a.txt

SO ./images/a.txt

WE ./images/a.txt

EA ./images/a.txt


F 220,100,0
C 225,30,0




11111111111111111111111111111
1N000000001100000011011111111
11100111111110011000000100011
11110111111111011101010000001
11000000110101011100000010001
10000000000000001100000010001
10000000000000001101010010001
11000001110101011111011110001
11111111111111111111111111111