
C 	102,178,152
EA 			./img/image2.xpm

         NO                	./img/image.xpm
                         
WE                  	  ./img/image4.xpm
SO                   	   ./img/image3.xpm
F	20,7,125



11111111111
101100000001
100101000001
100100000001
110111011111
100100000001
100001000001
100000100001
10000E000001
100100000001
111111111111